AAAAAAAAAA
ABAAAAAAAA
ABAAAAAAAA
ABAAAAAAAA
ABBBBBBAAA
AAAAAAAAAA
AAAAAAAAAA
AAAAAAAAAA
AAAAAAAAAA
AAAAAAAAAA